xxxxxxxxxxxxxxxxx
x               x
x               x
x            S  x
x               x
x               x
x               x
x               x
x  xxxxxxxxx    x
x          x    x
x  x xxxx  x    x
x  x      Gx    x
x  x            x
xxxxxxxxxxxxxxxxx